5

T :
0 0 0 0 0
0 1 2 0 0
0 0 0 0 0
0 0 0 0 0
0 0 0 0 3

L :
4 0 0 0 4
0 0 0 0 1
3 0 2 0 0
0 0 0 0 0
0 0 0 0 0

R :
5 0 0 6 0
0 0 0 5 0
0 6 0 0 0
0 0 0 0 0
0 0 0 0 0