5

T :
0 0 0 0 0
0 1 0 0 0
0 0 0 0 0
0 0 0 2 0
0 0 0 3 4

L :
0 0 2 0 0
0 0 4 0 0
0 0 0 0 0
0 0 0 0 0
0 0 0 0 0

R :
0 0 5 0 0
1 0 0 0 0
0 0 0 0 0
0 3 0 6 0
6 0 5 0 0