6

T :
0 0 0 0 0 0
0 0 0 0 0 0
0 0 1 0 0 0
0 0 0 0 0 0
0 0 0 0 0 0
0 0 0 2 0 3

L :
0 0 0 0 0 0
0 0 0 0 0 0
0 0 0 0 0 2
0 0 0 0 0 0
0 0 0 0 0 0
0 4 5 0 0 3
0 0 0 0 0 0

R :
0 0 0 0 0 0
1 0 6 -1 -1 0
0 0 0 -1 -1 0
0 0 0 -1 -1 0
5 0 4 -1 -1 0
6 0 0 0 0 0