5

T :
0 0 0 1 0
0 2 0 0 0
0 0 0 0 0
0 0 0 0 0
0 0 0 0 0

L :
0 0 0 0 3
0 0 0 4 0
0 0 0 5 2
0 0 0 0 0
0 0 0 0 0

R :
1 5 0 4 0
0 0 0 0 0
0 0 0 0 0
0 0 0 3 0
0 0 0 0 0